Kaupungissa – In the city
kauppa – shop, store
kauppakeskus – shopping center, mall
tavaratalo – department store
apteekki – pharmacy
kahvila – café
ravintola – restaurant
baari – bar
tori – market square
kauppahalli – market hall
kirjasto – library
museo – museum
linna – castle
kirkko – church
teatteri – theater
ooppera – opera
elokuvateatteri – cinema, movie theater
huvipuisto – amusement park
eläintarha – zoo
aukio – square, plaza
puisto – park
leikkipuisto – playground
uimaranta – beach (swimming beach)
satama – harbor, port
urheilukenttä, stadion – sports field, stadium
kaupungintalo – city hall
poliisiasema – police station
sairaala – hospital
terveysasema – health center, clinic
päiväkoti – kindergarten, daycare
koulu – school
yliopisto – university
katu – street
risteys – intersection
liikennevalot – traffic lights
jalkakäytävä – sidewalk, pavement
suojatie – pedestrian crossing, crosswalk
pyörätie – bicycle lane, bike path
pysäköinti, parkkipaikka – parking, parking lot
parkkitalo, parkkihalli – parking garage
bussipysäkki – bus stop
bussiasema, juna-asema – bus station, train station
lentoasema – airport
pyöräteline – bicycle rack
penkki – bench
patsas – statue